  #####
  #G  ###
 ## #B  #
##    G #
# GO #  #
#  B##B##
###  P #
  ######