######
#    #####
#  B # GG#
#PBBBB   #
#  B #G  #
#    #GGG#
##########