#########
#   #   #
# BG#GB #
# BGPGB #
# BG#GB #
#   #   #
#########