#######
#  # P#
# B O #
# G# ##
##   #
######