######
#    #
# #P #
# OO #
# GO #
#    #
######