######
#    #
# BP #
# OO #
# GO #
#    #
######